{
    "4264": 0,
    "4344": 1,
    "4347": 2,
    "4290": 3,
    "4293": 4,
    "4267": 5,
    "4527": 6,
    "4339": 7,
    "4462": 8,
    "4265": 9,
    "4436": 10,
    "4517": 11,
    "4386": 12,
    "4501": 13,
    "4528": 14,
    "4450": 15,
    "4420": 16,
    "4378": 17,
    "4463": 18,
    "4490": 19,
    "4529": 20,
    "4507": 21,
    "4541": 22,
    "4373": 23,
    "4438": 24,
    "4280": 25,
    "4515": 26,
    "4520": 27,
    "4292": 28,
    "4336": 29,
    "4389": 30,
    "4365": 31,
    "4349": 32,
    "4306": 33,
    "4340": 34,
    "4358": 35,
    "4360": 36,
    "4269": 37,
    "4362": 38,
    "4421": 39,
    "4474": 40,
    "4401": 41,
    "4341": 42,
    "4318": 43,
    "4468": 44,
    "4295": 45,
    "4357": 46,
    "4300": 47,
    "4399": 48,
    "4441": 49,
    "4508": 50,
    "4455": 51,
    "4496": 52,
    "4296": 53,
    "4473": 54,
    "4404": 55,
    "4382": 56,
    "4423": 57,
    "4509": 58,
    "4543": 59,
    "4412": 60,
    "4495": 61,
    "4282": 62,
    "4355": 63,
    "4492": 64,
    "4444": 65,
    "4489": 66,
    "4414": 67,
    "4312": 68,
    "4287": 69,
    "4372": 70,
    "4288": 71,
    "4523": 72,
    "4458": 73,
    "4415": 74,
    "4356": 75,
    "4429": 76,
    "4407": 77,
    "4370": 78,
    "4297": 79,
    "4387": 80,
    "4342": 81,
    "4330": 82,
    "4521": 83,
    "4394": 84,
    "4408": 85,
    "4491": 86,
    "4410": 87,
    "4319": 88,
    "4419": 89,
    "4532": 90,
    "4427": 91,
    "4400": 92,
    "4442": 93,
    "4374": 94,
    "4333": 95,
    "4430": 96,
    "4392": 97,
    "4451": 98,
    "4398": 99,
    "4486": 100,
    "4445": 101,
    "4518": 102,
    "4466": 103,
    "4449": 104,
    "4447": 105,
    "4437": 106,
    "4361": 107,
    "4443": 108,
    "4353": 109,
    "4332": 110,
    "4467": 111,
    "4482": 112,
    "4418": 113,
    "4484": 114,
    "4338": 115,
    "4498": 116,
    "4481": 117,
    "4542": 118,
    "4307": 119,
    "4526": 120,
    "4422": 121,
    "4274": 122,
    "4519": 123,
    "4278": 124,
    "4343": 125,
    "4272": 126,
    "4439": 127,
    "4540": 128,
    "4477": 129,
    "4337": 130,
    "4487": 131,
    "4346": 132,
    "4547": 133,
    "4539": 134,
    "4316": 135,
    "4393": 136,
    "4320": 137,
    "4411": 138,
    "4485": 139,
    "4531": 140,
    "4291": 141,
    "4506": 142,
    "4381": 143,
    "4536": 144,
    "4302": 145,
    "4428": 146,
    "4475": 147,
    "4366": 148,
    "4534": 149,
    "4298": 150,
    "4465": 151,
    "4493": 152,
    "4380": 153,
    "4513": 154,
    "4377": 155,
    "4275": 156,
    "4310": 157,
    "4546": 158,
    "4397": 159,
    "4270": 160,
    "4354": 161,
    "4432": 162,
    "4367": 163,
    "4375": 164,
    "4537": 165,
    "4403": 166,
    "4311": 167,
    "4516": 168,
    "4266": 169,
    "4416": 170,
    "4322": 171,
    "4315": 172,
    "4308": 173,
    "4285": 174,
    "4453": 175,
    "4325": 176,
    "4497": 177,
    "4395": 178,
    "4301": 179,
    "4413": 180,
    "4464": 181,
    "4499": 182,
    "4329": 183,
    "4425": 184,
    "4480": 185,
    "4396": 186,
    "4461": 187,
    "4479": 188,
    "4323": 189,
    "4284": 190,
    "4334": 191,
    "4503": 192,
    "4350": 193,
    "4276": 194,
    "4525": 195,
    "4351": 196,
    "4452": 197,
    "4345": 198,
    "4273": 199,
    "4512": 200,
    "4471": 201,
    "4331": 202,
    "4327": 203,
    "4314": 204,
    "4324": 205,
    "4530": 206,
    "4388": 207,
    "4426": 208,
    "4459": 209,
    "4383": 210,
    "4402": 211,
    "4545": 212,
    "4283": 213,
    "4460": 214,
    "4424": 215,
    "4433": 216,
    "4472": 217,
    "4268": 218,
    "4510": 219,
    "4348": 220,
    "4478": 221,
    "4371": 222,
    "4289": 223,
    "4309": 224,
    "4505": 225,
    "4538": 226,
    "4379": 227,
    "4409": 228,
    "4476": 229,
    "4385": 230,
    "4488": 231,
    "4294": 232,
    "4522": 233,
    "4286": 234,
    "4277": 235,
    "4368": 236,
    "4363": 237,
    "4313": 238,
    "4369": 239,
    "4303": 240,
    "4304": 241,
    "4524": 242,
    "4454": 243,
    "4384": 244,
    "4391": 245,
    "4483": 246,
    "4317": 247,
    "4431": 248,
    "4335": 249,
    "4533": 250,
    "4469": 251,
    "4326": 252,
    "4405": 253,
    "4448": 254,
    "4500": 255,
    "4406": 256,
    "4511": 257,
    "4514": 258,
    "4279": 259,
    "4321": 260,
    "4502": 261,
    "4359": 262,
    "4504": 263,
    "4434": 264,
    "4299": 265,
    "4435": 266,
    "4281": 267,
    "4390": 268,
    "4364": 269,
    "4535": 270,
    "4494": 271,
    "4271": 272,
    "4328": 273,
    "4352": 274,
    "4305": 275,
    "4446": 276,
    "4544": 277,
    "4440": 278,
    "4417": 279,
    "4376": 280,
    "4456": 281,
    "4457": 282,
    "4470": 283
}